t,value
1616024766,3
1616025066,1
1616025366,1
1616025666,1
1616025966,1
1616026266,0
1616026566,0
1616026866,0
1616027166,0
1616027372,0
1616027372,0
