t,value
1609312795,3
1609313095,1
1609313395,1
1609313695,1
1609313995,1
1609314295,1
1609314595,1
1609314600,0
1609314600,0
