t,value
1616140040,3
1616140340,1
1616140640,1
1616140940,1
1616141240,1
1616141540,0
1616141840,0
1616142140,0
1616142440,0
1616142740,0
1616143040,0
1616143340,0
1616143571,0
1616143571,0
