t,value
1609328641,3
1609328941,1
1609329241,1
1609329541,1
1609329841,1
1609330141,1
1609330441,1
1609330741,1
1609331041,1
1609331341,1
1609331343,0
1609331343,0
