t,value
1610004121,4
1610004421,0
1610004721,0
1610004739,0
1610004739,0
