t,value
1607771151,3
1607771451,1
1607771751,1
1607772051,1
1607772351,1
1607772651,1
1607772951,1
1607773251,1
1607773551,1
1607773851,1
1607774151,1
1607774451,1
1607774724,0
1607774724,0
