t,value
1609361164,3
1609361464,1
1609361764,1
1609362064,1
1609362364,1
1609362664,1
1609362964,1
1609363264,1
1609363564,1
1609363864,1
1609364164,1
1609364464,1
1609364764,1
1609364892,0
1609364892,0
