t,value
1609337604,3
1609337904,1
1609338204,1
1609338504,1
1609338804,1
1609339104,1
1609339404,1
1609339704,1
1609340004,1
1609340193,0
1609340193,0
