t,value
1616129776,3
1616130076,1
1616130376,1
1616130676,1
1616130976,1
1616131276,1
1616131576,1
1616131876,1
1616132176,0
1616132476,0
1616132776,0
1616133076,0
1616133164,0
1616133164,0
