t,value
1607846082,3
1607846382,1
1607846682,1
1607846982,1
1607847282,1
1607847582,1
1607847882,1
1607847993,0
1607847993,0
