t,value
1609307060,4
1609307360,0
1609307660,0
1609307960,0
1609308260,0
1609308352,0
1609308352,0
