t,value
1607740036,3
1607740336,1
1607740636,1
1607740936,1
1607741236,1
1607741536,1
1607741836,1
1607742136,1
1607742436,1
1607742736,1
1607743036,1
1607743336,1
1607743636,1
1607743936,1
1607744236,1
1607744390,0
1607744390,0
