t,value
1609351209,3
1609351509,1
1609351809,1
1609352109,1
1609352409,1
1609352709,1
1609353009,1
1609353309,1
1609353609,1
1609353909,0
1609353937,0
1609353937,0
