t,value
1610011063,4
1610011363,1
1610011663,0
1610011887,0
1610011887,0
