t,value
1609305035,3
1609305335,1
1609305635,1
1609305935,1
1609306235,1
1609306535,1
1609306750,0
1609306750,0
