t,value
1610668484,3
1610668784,1
1610669084,1
1610669384,1
1610669684,1
1610669984,1
1610670284,1
1610670584,1
1610670884,1
1610671184,1
1610671484,1
1610671784,1
1610671804,0
1610671804,0
