t,value
1607799649,3
1607799949,1
1607800249,1
1607800549,1
1607800849,1
1607801149,1
1607801449,1
1607801749,1
1607802049,1
1607802349,1
1607802649,1
1607802949,1
1607803249,1
1607803549,1
1607803849,1
1607803877,0
1607803877,0
