t,value
1607784521,3
1607784821,1
1607785121,1
1607785421,1
1607785721,1
1607786021,1
1607786321,1
1607786621,1
1607786921,1
1607787221,1
1607787521,1
1607787821,1
1607788121,1
1607788421,1
1607788485,0
1607788486,0
