t,value
1607822469,3
1607822769,1
1607823069,1
1607823369,1
1607823669,1
1607823969,1
1607824269,1
1607824569,1
1607824869,1
1607825169,1
1607825469,1
1607825769,1
1607826069,1
1607826231,0
1607826231,0
