t,value
1609292757,1
1609293057,1
1609293357,1
1609293657,1
1609293957,1
1609293977,0
1609293977,0
