t,value
1607807668,3
1607807968,1
1607808268,1
1607808568,1
1607808868,1
1607809168,1
1607809468,1
1607809768,1
1607810068,1
1607810368,1
1607810668,1
1607810968,1
1607811268,1
1607811568,1
1607811734,0
1607811734,0
