t,value
1607812047,3
1607812347,1
1607812647,1
1607812947,1
1607813247,1
1607813547,1
1607813847,1
1607814147,1
1607814447,1
1607814747,1
1607814965,0
1607814965,0
