t,value
1609371673,3
1609371973,1
1609372273,1
1609372573,1
1609372873,1
1609373173,1
1609373473,1
1609373773,1
1609374073,1
1609374373,1
1609374673,1
1609374973,1
1609375273,1
1609375573,1
1609375796,0
1609375796,0
