t,value
1607815276,3
1607815576,1
1607815876,1
1607816176,1
1607816476,1
1607816776,1
1607817076,1
1607817376,1
1607817676,1
1607817976,1
1607818276,1
1607818576,1
1607818876,1
1607819176,1
1607819255,0
1607819255,0
