t,value
1609314911,3
1609315211,1
1609315511,1
1609315811,1
1609316111,1
1609316411,1
1609316711,1
1609317011,1
1609317311,1
1609317611,1
1609317911,1
1609318211,1
1609318343,0
1609318343,0
