t,value
1607765898,3
1607766198,1
1607766498,1
1607766798,1
1607767098,1
1607767398,1
1607767698,1
1607767998,1
1607768298,1
1607768598,1
1607768898,1
1607769198,1
1607769498,1
1607769798,1
1607770098,1
1607770398,1
1607770698,1
1607770841,0
1607770841,0
