t,value
1607826544,3
1607826844,1
1607827144,1
1607827444,1
1607827744,1
1607828044,1
1607828344,1
1607828644,1
1607828875,0
1607828875,0
