t,value
1615580448,3
1615580748,1
1615581048,1
1615581348,1
1615581648,1
1615581948,1
1615582248,1
1615582548,1
1615582848,1
1615583148,1
1615583448,1
1615583748,1
1615584048,1
1615584348,1
1615584389,0
1615584389,0
