t,value
1609318653,3
1609318953,1
1609319253,1
1609319553,1
1609319853,1
1609320153,1
1609320453,1
1609320753,1
1609321045,0
1609321045,0
