t,value
1609323415,3
1609323715,1
1609324015,1
1609324315,1
1609324615,1
1609324915,1
1609325215,1
1609325515,1
1609325815,1
1609326074,0
1609326074,0
