t,value
1607775037,3
1607775337,1
1607775637,1
1607775937,1
1607776237,1
1607776537,1
1607776837,1
1607777137,1
1607777317,0
1607777317,0
