t,value
1610004121,3
1610004421,1
1610004721,1
1610004739,0
1610004739,0
