t,value
1607852932,3
1607853232,1
1607853532,1
1607853832,1
1607854132,1
1607854432,1
1607854732,1
1607855032,1
1607855156,0
1607855156,0
