t,value
1609395280,3
1609395580,1
1609395880,1
1609396180,1
1609396480,1
1609396780,1
1609397080,1
1609397365,0
1609397365,0
