t,value
1607833076,3
1607833376,1
1607833676,1
1607833976,1
1607834276,1
1607834576,1
1607834876,1
1607835176,1
1607835476,1
1607835776,1
1607836076,1
1607836376,1
1607836676,1
1607836976,1
1607837276,0
1607837376,0
1607837376,0
