t,value
1614113546,0
1614113846,0
1614114146,0
1614114446,0
1614114746,0
1614115046,0
1614115346,0
1614115646,0
1614115946,0
1614116246,0
1614116546,0
1614116846,0
1614117146,0
1614117211,0
1614117211,0
