t,value
1611776017,3
1611776317,1
1611776617,1
1611776917,1
1611777217,1
1611777518,1
1611777817,1
1611778117,0
1611778417,0
1611778717,0
1611779017,0
1611779317,0
1611779617,0
1611779709,0
1611779709,0
