t,value
1609331656,3
1609331956,1
1609332256,1
1609332556,1
1609332856,1
1609333156,1
1609333456,1
1609333756,1
1609334056,1
1609334068,0
1609334068,0
