t,value
1616024766,4
1616025066,0
1616025366,0
1616025666,0
1616025966,0
1616026266,0
1616026566,0
1616026866,0
1616027166,0
1616027372,0
1616027372,0
