t,value
1609346759,3
1609347059,1
1609347359,1
1609347659,1
1609347959,1
1609348259,1
1609348559,1
1609348859,1
1609349159,1
1609349459,1
1609349759,1
1609350059,1
1609350359,1
1609350659,1
1609350897,0
1609350897,0
