t,value
1616136019,4
1616136319,0
1616136619,0
1616136919,0
1616137219,0
1616137519,0
1616137819,0
1616138119,0
1616138419,0
1616138719,0
1616139019,0
1616139319,0
1616139619,0
1616139655,0
1616139655,0
