t,value
1607850981,2
1607851281,1
1607851581,1
1607851881,1
1607852181,1
1607852481,1
1607852624,0
1607852624,0
