t,value
1609365204,3
1609365504,1
1609365804,1
1609366104,1
1609366404,1
1609366704,1
1609367004,1
1609367304,1
1609367498,0
1609367498,0
