t,value
1609334380,3
1609334681,1
1609334981,1
1609335280,1
1609335580,1
1609335880,1
1609336180,1
1609336480,1
1609336780,1
1609337080,1
1609337291,0
1609337291,0
