t,value
1607840735,3
1607841035,1
1607841335,1
1607841635,1
1607841935,1
1607842235,1
1607842535,1
1607842835,0
1607842894,0
1607842894,0
