t,value
1607857180,3
1607857480,1
1607857780,1
1607858080,1
1607858380,1
1607858680,1
1607858980,1
1607859258,0
1607859258,0
