t,value
1609289922,3
1609290222,1
1609290522,1
1609290822,1
1609291122,1
1609291422,1
1609291537,0
1609291537,0
