t,value
1609308660,3
1609308960,1
1609309260,1
1609309560,1
1609309860,1
1609310160,1
1609310460,1
1609310521,0
1609310521,0
