t,value
1609343849,3
1609344149,1
1609344450,1
1609344749,1
1609345049,1
1609345349,1
1609345649,1
1609345949,1
1609346249,1
1609346447,0
1609346447,0
