t,value
1611506847,3
1611507147,1
1611507447,1
1611507747,1
1611508047,1
1611508347,1
1611508647,1
1611508947,1
1611509247,0
1611509547,0
1611509847,0
1611510147,0
1611510447,0
1611510747,0
1611511047,0
1611511347,0
1611511516,0
1611511516,0
