t,value
1610656236,2
1610656536,2
1610656836,2
1610657136,1
1610657436,1
1610657736,1
1610658036,1
1610658336,1
1610658636,1
1610658936,1
1610659236,1
1610659536,1
1610659836,1
1610660136,1
1610660287,0
1610660287,0
