t,value
1607755683,3
1607755983,1
1607756283,1
1607756583,1
1607756883,1
1607757183,1
1607757466,0
1607757466,0
