t,value
1607843203,3
1607843503,1
1607843803,1
1607844103,1
1607844403,1
1607844703,1
1607845003,1
1607845303,1
1607845603,1
1607845771,0
1607845771,0
