t,value
1609308660,4
1609308960,0
1609309260,0
1609309560,0
1609309860,0
1609310160,0
1609310460,0
1609310521,0
1609310521,0
