t,value
1607788800,4
1607789100,2
1607789400,0
1607789700,0
1607790000,0
1607790300,0
1607790600,0
1607790900,0
1607791200,0
1607791500,0
1607791579,0
1607791579,0
