t,value
1609321358,3
1609321658,1
1609321958,1
1609322258,1
1609322558,1
1609322858,1
1609323104,0
1609323104,0
