t,value
1609326385,3
1609326685,1
1609326985,1
1609327285,1
1609327585,1
1609327885,1
1609328185,1
1609328329,0
1609328329,0
