t,value
1607736783,1
1607737083,1
1607737383,1
1607737683,1
1607737983,1
1607738236,0
1607738237,0
