t,value
1609391093,3
1609391393,1
1609391693,1
1609391993,1
1609392293,1
1609392593,1
1609392893,1
1609393193,1
1609393305,0
1609393305,0
