t,value
1611776017,4
1611776317,0
1611776617,0
1611776917,0
1611777217,0
1611777518,0
1611777817,0
1611778117,0
1611778417,0
1611778717,0
1611779017,0
1611779317,0
1611779617,0
1611779709,0
1611779709,0
