t,value
1607744698,3
1607744998,1
1607745297,1
1607745597,1
1607745897,1
1607746197,1
1607746497,1
1607746720,0
1607746720,0
