t,value
1607848301,3
1607848601,1
1607848901,1
1607849201,1
1607849501,1
1607849801,1
1607850101,1
1607850401,1
1607850670,0
1607850670,0
