t,value
1609358416,3
1609358716,1
1609359016,1
1609359316,1
1609359616,1
1609359916,1
1609360216,1
1609360516,1
1609360816,0
1609360853,0
1609360853,0
