t,value
1607781679,3
1607781979,1
1607782279,1
1607782579,1
1607782879,1
1607783179,1
1607783479,1
1607783779,1
1607784079,1
1607784210,0
1607784210,0
