t,value
1609376105,3
1609376405,1
1609376705,1
1609377005,1
1609377305,1
1609377605,1
1609377905,1
1609378205,1
1609378505,1
1609378805,0
1609378805,0
1609378805,0
