t,value
1607819568,3
1607819868,1
1607820168,1
1607820468,1
1607820768,1
1607821068,1
1607821368,1
1607821668,1
1607821968,1
1607822158,0
1607822158,0
