t,value
1607753047,3
1607753347,1
1607753647,1
1607753947,1
1607754247,1
1607754547,1
1607754847,1
1607755147,1
1607755373,0
1607755373,0
