t,value
1607748684,3
1607748984,1
1607749284,1
1607749584,1
1607749884,1
1607750184,1
1607750484,1
1607750784,1
1607750869,0
1607750869,0
