t,value
1609314911,4
1609315211,0
1609315511,0
1609315811,0
1609316111,0
1609316411,0
1609316711,0
1609317011,0
1609317311,0
1609317611,0
1609317911,0
1609318211,0
1609318343,0
1609318343,0
