t,value
1607757775,3
1607758075,1
1607758375,1
1607758675,1
1607758975,1
1607759275,1
1607759575,1
1607759875,1
1607760175,1
1607760284,0
1607760284,0
