t,value
1607796302,3
1607796602,1
1607796902,1
1607797202,1
1607797502,1
1607797802,1
1607798102,1
1607798402,1
1607798702,1
1607799002,1
1607799302,1
1607799337,0
1607799337,0
