t,value
1607837686,3
1607837986,1
1607838286,1
1607838586,1
1607838886,1
1607839186,1
1607839486,1
1607839786,1
1607840086,1
1607840386,1
1607840423,0
1607840423,0
