t,value
1607804191,3
1607804491,1
1607804791,1
1607805091,1
1607805391,1
1607805691,1
1607805991,1
1607806291,1
1607806591,1
1607806891,1
1607807191,1
1607807356,0
1607807356,0
