t,value
1607788800,3
1607789100,1
1607789400,1
1607789700,1
1607790000,1
1607790300,1
1607790600,1
1607790900,1
1607791200,1
1607791500,1
1607791579,0
1607791579,0
