t,value
1607775037,0
1607775337,0
1607775637,0
1607775937,0
1607776237,0
1607776537,0
1607776837,0
1607777137,0
1607777317,0
1607777317,0
