t,value
1610009086,4
1610009386,0
1610009686,0
1610009957,0
1610009957,0
