t,value
1607829184,3
1607829484,1
1607829784,1
1607830084,1
1607830384,1
1607830684,1
1607830984,1
1607831284,1
1607831584,1
1607831884,1
1607832184,1
1607832484,1
1607832764,0
1607832764,0
