t,value
1610700168,3
1610700468,1
1610700768,1
1610701068,1
1610701368,1
1610701668,1
1610701968,1
1610702268,1
1610702568,1
1610702868,1
1610703168,1
1610703357,0
1610703357,0
