t,value
1607777628,3
1607777928,1
1607778228,1
1607778528,1
1607778828,1
1607779128,1
1607779428,1
1607779728,1
1607780028,1
1607780328,1
1607780628,1
1607780928,1
1607781228,1
1607781365,0
1607781365,0
