t,value
1607762922,3
1607763222,1
1607763522,1
1607763822,1
1607764122,1
1607764422,1
1607764722,1
1607765022,1
1607765322,1
1607765586,0
1607765586,0
