t,value
1607864192,1
1607864492,1
1607864792,1
1607865092,1
1607865392,1
1607865684,0
1607865684,0
