t,value
1609301506,3
1609301806,1
1609302106,1
1609302406,1
1609302706,1
1609303006,1
1609303189,0
1609303189,0
