t,value
1609340506,3
1609340806,1
1609341106,1
1609341406,1
1609341706,1
1609342006,1
1609342306,1
1609342606,1
1609342906,1
1609343206,1
1609343506,1
1609343536,0
1609343536,0
