t,value
1609384373,3
1609384673,1
1609384973,1
1609385273,1
1609385573,1
1609385873,1
1609386173,0
1609386227,0
1609386227,0
