t,value
1609354248,3
1609354548,1
1609354848,1
1609355148,1
1609355448,1
1609355748,1
1609356048,1
1609356348,1
1609356648,1
1609356948,1
1609357248,1
1609357548,1
1609357848,1
1609358104,0
1609358104,0
