t,value
1609379115,3
1609379415,1
1609379715,1
1609380015,1
1609380315,1
1609380615,1
1609380915,1
1609381122,0
1609381122,0
