t,value
1609367807,3
1609368107,1
1609368407,1
1609368707,1
1609369007,1
1609369307,1
1609369607,1
1609369907,1
1609370207,1
1609370507,1
1609370807,1
1609371107,1
1609371362,0
1609371362,0
