t,value
1607760595,3
1607760895,1
1607761195,1
1607761495,1
1607761795,1
1607762095,1
1607762395,1
1607762612,0
1607762612,0
