t,value
1607791890,3
1607792190,1
1607792490,1
1607792790,1
1607793090,1
1607793390,1
1607793690,1
1607793990,1
1607794290,1
1607794590,1
1607794890,1
1607795190,1
1607795490,1
1607795790,1
1607795988,0
1607795988,0
