t,value
1607751178,3
1607751478,1
1607751778,1
1607752078,1
1607752378,1
1607752678,1
1607752739,0
1607752739,0
