t,value
1609381430,3
1609381730,1
1609382030,1
1609382330,1
1609382630,1
1609382930,1
1609383230,1
1609383530,1
1609383830,1
1609384063,0
1609384063,0
