t,value
1609386535,3
1609386835,1
1609387135,1
1609387435,1
1609387735,1
1609388035,1
1609388335,1
1609388635,1
1609388933,0
1609388933,0
