t,value
1609295383,3
1609295683,1
1609295983,1
1609296283,1
1609296583,1
1609296883,1
1609297183,1
1609297483,1
1609297783,1
1609298083,1
1609298176,0
1609298176,0
