t,value
1609310831,3
1609311131,1
1609311431,1
1609311731,1
1609312031,1
1609312331,1
1609312485,0
1609312485,0
