t,value
1611378329,3
1611378629,1
1611378929,1
1611379229,1
1611379529,0
1611379829,0
1611380129,0
1611380429,0
1611380729,0
1611381029,0
1611381329,0
1611381629,0
1611381929,0
1611382111,0
1611382111,0
